artists	iso_countries
18pm - homeschool	
A Projection - Darwin's Eden	SE
ACTORS - Face Meets Glass	CA
Agent Side Grinder - Stripdown	SE
AGTHA - K3Pt (AGTHA Remix)	
akiaura - Deathwish	RU;US
akiaura - Sleepwalker	RU
Amaur - drowning in the night	
Amber Jay - The House	
Amiture - Touch	US
Antipole;Paris Alexander - Perceptions	NO
Antipole;Paris Alexander - Syndrome	NO
Ari Abdul - BABYDOLL	US
Ari Abdul - BABYDOLL (Speed)	US
Ari Abdul - Hush	US
Ari Abdul - Stay	US
Ari Abdul - Taste	US
Artemas - i like the way you kiss me	GB
Ash Code - Dry Your Eyes	IT
Ash Code - Nostalgia	IT
Automelodi - La poussière	CA
Balduvian Bears - Dialogue	US
Balvanera - Scene	AR
Balvanera - Saviour (Shpshft Remix)	AR
Black Marble - Cruel Summer	US
Blind Delon - Edouard	FR
Blind Delon - Elle	FR
Blood Orchid - Doom & Gloom	
Body of Light - How Do I Know?	US
Box And The Twins - This Place Called Nowhere	DE
Boy Harsher - A Realness	US
Boy Harsher - Burn it Down	US
Boy Harsher - Escape	US
Boy Harsher - Face the Fire	US
Boy Harsher - Fate	US
Boy Harsher - Give Me a Reason	US
Boy Harsher - LA	US
Boy Harsher - Lost	US
Boy Harsher - Lust	US
Boy Harsher - Morphine	US
Boy Harsher - Motion	US
Boy Harsher - Pain	US
Boy Harsher - Send Me a Vision	US
Boy Harsher - Spell	US
Boy Harsher - Tears	US
Boy Harsher - The Look You Gave (Jerry)	US
Boy Harsher - Yr Body Is Nothing	US
Bragolin - Into Those Woods	NL
Bragolin - This Grotesque Dance	NL
Bragolin - To Hide to Shine to Cross	NL
Bragolin;Adam Tristar - The End Dwells in Us All	NL
Cabaret Nocturne - Blind Trust - Original Mix	
Caroline Rose - Jeannie Becomes A Mom	US
Carrellee - Not Here For Fun	US
Casket Cassette - Into the Sun	US
Cathedral Bells - Ephemeral	US
Cemeteries - Sodus	US
Chelsea Wolfe - House Of Self-Undoing (Boy Harsher remix)	US
Clan of Xymox - A Forest	NL
Clan of Xymox - Jasmine & Rose	NL
Clan of Xymox - She	NL
Closed Tear - Luna	
Cold Cave - Confetti	US
Cold Cave - Glory	US
Cold Cave - My Heart Is Immortal	US
Cristoforo Donadi - Innocence	
Crying Vessel - The Abyss	CH
Crystal Castles - Celestica	CA
Crystal Castles - Suffocation	CA
Cult Club;Zanias - Play with Lies	DE
Dance Divine - Salvation	DE
Dark - Gothic Love	DE
Dark - IN THE DARK YOU DIE	DE
Dark - SKELETON DANCE	DE
Darkø - Vision of Reality	
Dead Husband - Icebox	
Dead Husband - Memory	
Dead Husband - Plastic Mind	
Deep Down Wise - Ambers	
Deep Down Wise - Out of Sight	
Denuit - Cendre	FR
Denuit - CYANURE	FR
Denuit ft Emmon - nocturnal VISION	
Denuit - Tears Fall	FR
Deus Ex Lumina;Antipole - Destroy	DE
DIGITAL REY - LAST WISH	
Dionnysuss - Fangs	UZ
Dionnysuss;Sad Madona - Intoxication	UZ;FR
Dlina Volny - Bipolar	LT
Dlina Volny - Dance Me Away	LT
Dlina Volny - Dance Me (Minuit Machine Remix)	
Dlina Volny - Dazed	LT
Dlina Volny - Flair	LT
Dlina Volny - Whatever Happens Next	LT
Dream Affair - The Porter	
Ductape - Veil of Lies	TR
Echoberyl - A Prey	FR
Echoberyl - Apparition	FR
Echoberyl - Into the Beyond	FR
Echoberyl - Mother Solitude (Club Version)	FR
Echoberyl - Rising from the Dead	FR
Echoberyl - Salome (Suffer Me)	FR
Echoberyl - Silent Monster (The Other Side of the Mirror)	FR
Echoberyl;Gloria de Oliveira - The Siren and the Ghost	FR
Elley Duhé - MIDDLE OF THE NIGHT	US
Fearing - I Was So Alive	US
FM Attack - Ultraviolet	CA
Foie Gras - Psychic Sobriety	US
Forever Grey - Broken Home	US
Forever Grey - Common Coffin	US
Forever Grey - Familiar Faces	US
Forever Grey - Lucid Dreaming	US
Forever Grey - Nothing Ever Changes	US
Forever Grey - People Ask My Age	US
Forever Grey - Seasons	US
Forever Grey - The Other Side	US
Fragrance - A Million Replays	FR
Fragrance - Collapse	FR
Fragrance - Covered In Gold	FR
Fragrance - Crawling to the Void	FR
Fragrance - Forevermore	FR
Fragrance - Gone in a Wink	FR
Fragrance - Gravity & Grace	FR
Fragrance - Hanté de moi	FR
Fragrance - Love Bites	FR
Fragrance - Mise en garde	FR
Fragrance - Much More Like A Wave	FR
Fragrance - So Typical	FR
Fragrance - Tears	FR
Fragrance - Tears (Mareux Remix)	FR
Fragrance - The Missing Part	FR
Fragrance - Twisted Way	FR
Fragrance - So Typical (Julia Bondar Remix)	
Fragrance;Lulannie - The Cure	FR
Fragrance;Maya Postepski - At Last (Opale Sad Mix)	FR;CA
framed - drowning	
French Police - Club De Vampiros	US
Galatée - Chantez Vous Haut Et Fort	
Galatée - Le Miroir Fantastique	RU
Galatée - Mes Démons	RU
Galatée - Ne sois pas triste	RU
Galatée - Tapis Rouge	
Galatée - Vivre Sa Vie (Princess De Suède)	
Geometric Vision - Jelly Dream	IT
Ghost Cop - A Shot in the Dark	US
Ghost Cop - All Souls Day	US
Ghost Cop - Problems	US
Girl As Wave - Amnesia	US
Girl As Wave - Asteroids	US
Girl As Wave - From The Blue	
Girl As Wave - Future Version	US
Girl As Wave - Other Side	
Girl As Wave - Sparks	
Girl As Wave - Superstition	US
Glaare - First Rain	US
Glaring - Consciousness	DE
Glaring - Insanity Among Penguins	DE
Glaring - Paralyzed	DE
Glaring - Wie Lange Noch	DE
Glass Spells - Thrills	US
Glass Spells - Venom	US
Gloria de Oliveira - The Only Witness (The Wide Eye Remix)	FR
glwzbll - Untitled #13	RU
GOLD ZEBRA - Leaving the City	CA
Goo Munday - Blackjack	
Goo Munday - Where did you go?	AU
Goo Munday - Yes	AU
Hallows - All That Is True Dies	US
Hallows - Things That Hurt	US
Hante. - Beyond The Waves	FR
Hante. - In Raptures	FR
Hante. - Live to Die Another Day	FR
Hante. - Living in a French Movie	FR
Hante. - My Destruction	FR
Hante. - Noir	FR
Hante. - Que Reste-t-il de Notre Amour ?	FR
Hante. - Une Nuit Avec Mon Ennemi	FR
Hante. - À Contrecoeur	FR
Hante. - Éternité	FR
Hante.;Fragrance;Marble Slave - Nobody's Watching	FR
Hante. - RESPECT (Milliken Chamber Remix)	FR
Harsh Symmetry - Blind	US
Harsh Symmetry - Crystal Smile	US
Harsh Symmetry - Mirror Twin	US
Harsh Symmetry - Mirror Twin (live)	
Harsh Symmetry - Pugilist	US
Harsh Symmetry - Skin	US
Haunt Me - La Noche Eterna	US
Haunt Me - Watch You Bleed	US
hazy waters - deep waters	GB
Hendriek Bleik - Thriftstore	
HUIR - Arch	ES
Hørd - #02	
IAMTHESHADOW - As The Infinite Drowns	PT
IAMTHESHADOW - Everything in this Nothingness	PT
IAMTHESHADOW - Fall Apart	PT
IAMTHESHADOW - This Violence	PT
Indie Anthony - dance away tonight	
Inhalt - Occupations	
ionnalee - NOT HUMAN (TR/ST Remix)	SE
Iron Years - Lucid	US
Iron Years - Nostalgia	US
John Maus - Bennington (2007)	
juhvahn;Perpetualll - Sapphire	
Julia Bondar - Lust	ES
Julia Bondar - Fleurs Du Mal (Fragrance Remix)	ES
Kavinsky - Nightcall	FR
keelse - только не плачь	
Keep Shelly In Athens - Silent Rain	GR
Killing Joke - Love Like Blood	GB
KOMPROMAT;Vitalic;Rebeka Warrior - Niemand	FR
Kraftwerk - The Model - 2009 Remaster	
Kælan Mikla - Draumadís	IS
Kælan Mikla - Ósýnileg	IS
Labyrinth Ear - Lithium	GB
Labyrinth Ear - Lorna	GB
Labyrinth Ear - Lorna (kauf remix)	GB
Labyrinth Ear - Navy Light - 4am Mix	
Labyrinth Ear - Urchin	GB
Labyrinth Ear - Wild Flowers	GB
LAUREL - Best I Ever Had	GB
Le Blonde - The Voices	US
LEATHERS - Highrise	CA
LEATHERS - Phantom Heart	CA
Lebanon Hanover - Babes of the 80s	DE
Lebanon Hanover - Gallowdance	DE
Lebanon Hanover - Gallowdance (Deflex Rave Edit)	DE
Lebanon Hanover - Stahlwerk	DE
Lebanon Hanover - The Last Thing	DE
Lebanon Hanover - Babes of the 80s (Tobias Bernstrup)	DE
Lecomte De Brégeot;Elle Valenci - Paris 1985	
Linea Aspera - Attica	GB
Linea Aspera - Entanglement	GB
Linea Aspera - Eviction	GB
Linea Aspera - Fer-De-Lance	GB
Linea Aspera - Lamanai	GB
Linea Aspera - Malarone	GB
Linea Aspera - Redshift	GB
Lllyric? - Looking For The Answer	
Lone Assembly - Seven Souls - Remastered	
Luna - Спящая красавица	
Léonie Pernet - Butterfly	FR
M!R!M - At Night	IT
M!R!M - Survive	IT
M!R!M - Testament	IT
Madeline Goldstein - 1996 Expectations	US
Madeline Goldstein - Death's Door	US
Madeline Goldstein - One More Day	US
Madeline Goldstein;Some Ember - One More Day (DJ Dave-G Ext. Version)	
Magic Wands - Cyan Blue	
Magic Wands - Loveline	US
Magnified Desire - Dead Flowers	AU
Magnified Desire - Last Night	
Magnified Desire - Virginity	AU
Male Tears - Hit Me	US
Mannequin - Limits	
Mareux - Blackout	
Mareux - Choke	US
Mareux - Dance Floor Dolor	US
Mareux - Dark Paradise	
Mareux - Gopnik	US
Mareux - Killer	US
Mareux - Leech	
Mareux - Lovers From The Past	US
Mareux - Night Vision	US
Mareux - Sail	US
Mareux - Spectral Tease	US
Mareux - Summertime	US
Mareux - The Perfect Girl	US
Mareux;Dj Fn1 - Spectral Tease (Dj Fn1 Edit)	
Mareux - Glass (feat. King Woman)	
mary in the junkyard - ghost	GB
Mercy Girl - Heaven	
Mercy Girl - I'm In Love	
Mercy Girl - No Sound	
Midi Memory - Anywhere, Anytime	
Minimal Schlager - FMB	
Minimal Schlager - Forbidden Fruit	
Minuit Machine - 98	FR
Minuit Machine - Basic Needs	FR
Minuit Machine - Black Is My Anger	FR
Minuit Machine - Cent fois	FR
Minuit Machine - Chaos	FR
Minuit Machine - DRGS	FR
Minuit Machine - Empty Shell	FR
Minuit Machine - Everlasting	FR
Minuit Machine - Famous or Dead	FR
Minuit Machine - Fear Of Missing Out	FR
Minuit Machine - Hold Me	FR
Minuit Machine - Honey	FR
Minuit Machine - Lovers Of The Night	FR
Minuit Machine - Lovers Of The Night	FR
Minuit Machine - Party People	FR
Minuit Machine - Prey/Hunter	FR
Minuit Machine - Sabotage	FR
Minuit Machine - Sacrifice	FR
Minuit Machine - Shifting	FR
Minuit Machine - Sisters	FR
Minuit Machine - The Earth	FR
Minuit Machine - Vanity	FR
Minuit Machine - Don't Run From The Fire (Maud Geffray Remix)	FR
Minuit Machine - Honey (RAUMM Remix)	FR
МИРТЛ - Догорает	
MitroWave;leah julia - Curses	
Molchat Doma - На Дне	
Molchat Doma - Тоска	
Molly Nilsson - I Hope You Die	XE
moonvampire - shadows	KZ
moonvampire;Staarz - cigarette burns - remix (slowed)	
Motorama - Up	RU
Mr.Kitty - Shadow Dancer	US
My Manifesto - Bleach	US
My Manifesto;Carrellee - Autopilot	
Neu-Romancer - Blindsight	DE
New Today - Suicidal	US
Night Haze - Misbehave	
Night in Athens - Frozen Landscape	GB
Night in Athens - I Search For A Sign	GB
Night in Athens - Metropolis	GB
Night in Athens - Pressure	GB
Night in Athens - Words Unspoken	GB
Nightbus - Angles Mortz	
Nightbus - Way Past Three	
Nightcrawler feat. Celine - Enfer (Old Coroner Remix)	ES;FR
niteboi - u.	
NNHMN - Black Palms	DE
NNHMN - Bring it on	DE
NNHMN - Gloomy Heart	DE
NNHMN - In Darkness	DE
NNHMN - Magic Man	DE
NNHMN - Nrl	DE
NNHMN - Shadow in the Dark	DE
NNHMN - Soldier of Beauty	DE
NNHMN - Special	DE
NNHMN - The River of Fire	DE
NNHMN - Tomorrow's Heroine	DE
NNHMN - Unreal	DE
NNHMN - Your Demon	DE
noturgf - Suffocation - Slowed	
noturgf - Suffocation - Sped Up	
Nouvelle Phénomène - All Away	
Nouvelle Phénomène - Caresse	
Nouvelle Phénomène - Not a sin	
Nouvelle Phénomène - Talk to Me	
Nuovo Testamento - Exposure	US
Nuovo Testamento - Prayers	US
Nürnberg - Biessensoŭnasć	BY
Obsolet - Zwielicht	
Opale - Alejandro's Theme	FR
Opale - Eternelle Nostalgie	FR
Opale - Hédoniste	FR
Opale - Les Champs Magnetiques - Luminous Version	
Opale - Sleepless	FR
Opale - Sparkles and Wine	FR
Orion - Higher	US
Otha - I'm on Top	NO
Paradox Obscur - Universe	GR
Paradox Obscur - X-Spell	GR
Pastel Ghost - 3NDL3SS	US
Pastel Ghost - Dark Beach	US
Pastel Ghost - Embrace	US
Pastel Ghost - Iris	US
Pastel Ghost - Mercury	US
Pastel Ghost - Possession	US
Pastel Ghost - Pulse	US
Pastel Ghost - Sakura	US
Pastel Ghost - Shadows	US
Pastel Ghost - Translucid	US
Pastel Ghost - Underwater	US
Pastel Ghost - Shadows (Sidewalks and Skeletons Remix)	US
Pearly Drops - Bloom For Me	FI
PERMSKY KRAY - Дорогой Человек	RU
PERMSKY KRAY - Лавандовый Город	RU
PERMSKY KRAY - Самый Худший День	RU
Perverse State - Haunted	
Phantogram - Black Out Days (Future Islands Remix)	US
Pixel Grip - Reason to Stay	US
Pixel Grip - Split	US
plenka - Call Me	RU
plenka - Closed	RU
Potochkine - Possédée	
Prince Innocence - Blue Star	CA
Prince Innocence - Manic	CA
Psyche - Unveiling the Secret	CA
Pulp - Countdown	GB
Pulsations - Delusional Paragon	DK
R. Missing - All Alone With Seas	
R. Missing - Anomie by the Lake	
R. Missing - Birthright	US
R. Missing - Cloud Without Tear	US
R. Missing - Crimeless	US
R. Missing - Cry Quicker	
R. Missing - Dear Contests	US
R. Missing - Deeper Holes	US
R. Missing - Dreamletting	US
R. Missing - Falling Girl	
R. Missing - Get Careful Darker	
R. Missing - Heavens Lower	
R. Missing - How to Slow a Dream	
R. Missing - infinifalls	US
R. Missing - infinifalls	US
R. Missing - Kelly Was a Philistine	US
R. Missing - Maryhead	
R. Missing - Mostly Back	US
R. Missing - My Time As a Ghostly Someone Else	
R. Missing - New Present City	US
R. Missing - Nitelike	
R. Missing - Ola Tremble	US
R. Missing - Placeholder for the Night	US
R. Missing - Placelessness	US
R. Missing - Saturnining	US
R. Missing - Sleep Will Darken It	
R. Missing - Snow Club International - nightskippingmix	
R. Missing - Supermuted	US
R. Missing - Take Your Pleasure Sadly	
R. Missing - Take Your Pleasure Sadly v2	
R. Missing - The Down That Creeps	
R. Missing - Unsummering	US
R. Missing;Johan Agebjörn - Fakesnow	
R. Missing;Levingtquatre - Eveningpol	
R. Missing - Verónica Pass (Sally Shapiro Mix)	
Rare DM - send nudes	US
Rare DM - Skater Hits Me Harder	
Rendez Vous - Plasticity	FR
Rendez Vous - Youth	FR
Riki - Marigold	US
Riki - Napoleon	US
Röyksopp - 'Oh, Lover' ft. Susanne Sundfør	
Röyksopp - Running To The Sea	NO
Rude 66 - The 1000 Year Storm	NL
Rue Oberkampf - 89 degrees	DE
Rue Oberkampf - Glycine	DE
Rue Oberkampf - Happiness	DE
Rue Oberkampf - I Won't Surrender	DE
Rue Oberkampf - Somebody Else	DE
Rue Oberkampf - Tokyo	DE
Rupert Falsch - Moose und Farne (Energieberater Remix)	
Rusty Egan;Boy George - Turn to Dust	GB
S Y Z Y G Y X - Gimme Chaos	US
S Y Z Y G Y X - In Pieces	US
S Y Z Y G Y X - Kill the Pain	US
Sad Madona - Blush	
Sad Madona - Cemetery	FR
Sad Madona - Crimes	FR
Sad Madona - Love balmain	FR
Sad Madona - Vampire weekend	
Sad Madona;Mega Sega Drive Club - Idole	FR
Sally Dige - Forget Me	DE
Sally Dige - It's You I'm Thinking Of	DE
Scarlett Scarlett;Velvet Lion - I Want To Be Pure (Bonus Track)	
SCRATCH MASSIVE - CLOSER ft CHLOE [DOELD REMIX]	
Scratch Massive - Inner Symphony	FR
Scratch Massive - Last Dance	FR
Scratch Massive - Over Again	FR
Scratch Massive - Paris	FR
Scratch Massive - Sunken	FR
SCRATCH MASSIVE x JEANNE ADDED - YOU CAN’T HIDE	FR
SDH (Semiotics Department of Heteronyms) - Balance	
SDH (Semiotics Department of Heteronyms) - Cellular Sky	
SDH (Semiotics Department of Heteronyms) - Four Arms	
SDH (Semiotics Department of Heteronyms) - Hectic	
SDH (Semiotics Department of Heteronyms) - Hollowed Out	
SDH (Semiotics Department of Heteronyms) - Our Fear	
SDH (Semiotics Department of Heteronyms) - Poem Against Strong Thinking	
SDH (Semiotics Department of Heteronyms) - Suffer	
SDH (Semiotics Department of Heteronyms) - Talk In Dreams	
SDH (Semiotics Department of Heteronyms) - You Pt. 12	
Second Still - The Future	US
Sexual Purity - Chains	UA
Sexual Purity - Convulsion	UA
Sexual Purity - Convulsion + Chains (live)	
Sexual Purity - Don't touch 	UA
Sexual Purity - Forever	UA
Sexual Purity - Heart	UA
Sexual Purity - Never	UA
Sexual Purity - Runaway	UA
Sexual Purity - The Path	UA
Shad Shadows - Nocturnal	IT
Shad Shadows - Sad Bodies	IT
She Past Away - Durdu Dunya	TR
She Past Away - Durdu Dunya (Boy Harsher Remix)	TR
She Past Away - Rituel	TR
She Past Away - Ruh (Bragolin Remix)	TR
Shortwire - Reconfig (Shikimo Remix)	
Sidewalks and Skeletons - DISSOLVE	
Sidewalks and Skeletons - Euthanasia Daze	GB
Sidewalks and Skeletons - Goth	GB
Sidewalks and Skeletons - White Light	GB
Sidewalks and Skeletons;CASHFORGOLD - Eternal Rest	GB
Sidewalks and Skeletons;Goo Munday - Shadow	GB;AU
Silent Runners - Make It Right	NL
Silverbullit - Orion 2 - Bonus Track	
SINE;AwareNess - Dark Matters	US
SINE - Trauma Bondage	DE
Sinnerella - Eyes Without A Face	
Sixth June - Back for a Day	RS
Sixth June - Dance With Me - Single Mix	
Sixth June - Negde Neko	RS
Sixth June - Oh Boy	RS
Skeleton Hands - Ravage	US
Skeleton Hands - Oxygen	US
Slove ft Sarah Rebecca - Flash	
Soft Kill - Whirl	US
soft siren - 4am	US
SOFT VEIN - FALLING (Twin Tribes Remix)	US
SPELLSWØRD - PORTALS	
Ssleeping Desiress - Interior Lives	US
Ssleeping Desiress - We Need	US
Still Corners - Lost Boys	GB
Sydney Valette - Hold On	FR
Sydney Valette - Please	FR
Sydney Valette - So Long	FR
Sydney Valette - So Lost	FR
Tame Impala - Feels Like We Only Go Backwards	AU
Tempers - Capital Pains	US
Tempers - Daydreams	US
Tempers - Hell Hotline	US
Tempers - Leonard Cohen Afterworld	US
Tempers - Strange Harvest	US
Tempers - Unfamiliar	US
Terror Forms - High Jump	
Terror Forms - Opaque	US
Terror Forms - Vril	
The Agnes Circle - Porcelain	GB
The Agnes Circle - White Gate	GB
The frozen Autumn - Is Everything Real?	IT
The KVB - Above Us	GB
The KVB - Always Then - 2017 Version	
The KVB - Hands	GB
The KVB - Labyrinths	GB
The KVB - Overload	GB
The KVB - Tremors	GB
The Masqs - the noise	
The Masqs;Sad Madona - EXTRANA	FR
The Neighbourhood - Daddy Issues	US
The Neighbourhood - Reflections	US
The Neighbourhood - Softcore	US
The Spoiled - Love Is Pain	IT
The Toxic Avenger - Sorcery	FR
The Weeknd - Save Your Tears (with Ariana Grande)	
Them Are Us Too - Amends	US
This Cold Night - A Letter To Myself	US
Tone Ranger;Evelyn Drach - Dark Horse	
topographies - Tied	US
TR/ST - Are We Arc?	
TR/ST - Bicep	CA
TR/ST - Bulbform	
TR/ST - Candy Walls	
TR/ST - Capitol	CA
TR/ST - Chrissy E	
TR/ST - Colossal	CA
TR/ST - Divine	
TR/ST - Dressed For Space	
TR/ST - F.T.F.	
TR/ST - Four Gut	
TR/ST - Gloryhole	
TR/ST - Grouch	CA
TR/ST - Icabod	
TR/ST - Joyland	
TR/ST - Lost Souls/Eelings	CA
TR/ST - Peer Pressure	CA
TR/ST - Robrash - Instrumental	
TR/ST - Shoom	CA
TR/ST - Sulk	
TR/ST - The Dazzle	
TR/ST - The Last Dregs	
TRAITRS - The Lovely Wounded	CA
TRAITRS - The Suffering of Spiders	CA
TRAITRS - Thin Flesh	CA
Trevor Something - Confessions of an Addict	US
Trevor Something - The Ghost	US
Trit95 - Wine	
Turbo Knight;Edictum - Eleos	FI;AT
TWIN ION ENGINE - Feelings	US
Twin Tribes - Fantasmas	US
Twin Tribes - Heart & Feather	US
Twin Tribes - Monolith	US
Twin Tribes - Shadows	US
Twin Tribes - The River	US
Tying Tiffany - A Lone Boy	IT
Tying Tiffany - One Second	IT
ULTRA SUNN - Can You Believe It	BE
ULTRA SUNN - Distress	BE
ULTRA SUNN - Hard Feeling	BE
ULTRA SUNN - Keep Your Eyes Peeled	BE
ULTRA SUNN - Night Is Mine	BE
ULTRA SUNN - Out of the Cage	BE
ULTRA SUNN - The Eye	BE
ULTRA SUNN - The Speed	BE
ULTRA SUNN - Young Foxes	BE
Vandal Moon - Hurt	US
Velvet Condom - Collapse In Slow Motion	DE
Vestron Vulture - Always Down	MX
Vestron Vulture - Judas Effect	MX
Vestron Vulture - Motion Sickness	MX
Vestron Vulture - Phantom	MX
Vestron Vulture - Sadistic Glee	MX
Vestron Vulture - TELL ME WHEN I'M TELLING LIES	MX
VH X RR - Heavenly Outline	US
Vick Vapors - Only Human	
Vick Vapors;Fevr - Kiss Me	
Vioflesh - Always	CL
Vioflesh - Ashes	CL
Vioflesh - Midnight	CL
Vioflesh - Naked	CL
Vioflesh - Spring Nostalgia	CL
Vioflesh - Waves	CL
Vioflesh;Flesh - On My Skin	
VNV Nation - When is the Future?	DE
Vogue.Noir - A Reflex	
Vogue.Noir - Belief	
Vogue.Noir - Love Like Vampire	GB
Vogue.Noir - Memento	
Vogue.Noir - Resolution	
Vogue.Noir - She Is Frail	
Vogue.Noir - Strange Days, Pt. 2	
Vogue.Noir - Stratosphere	
Vogue.Noir - Void	
Vogue.Noir;DRIFT. - Segments	GB
Void Vision - Sour	US
Void Vision - The Source	US
VOITH - Falling In Love With You	
VOITH - Forever Dead To Me	
VOITH - Kraftwerk (Roboterkönige)	
VOITH - My Shadowblade	
VOITH - On The Night Of Halloween	
Waveshaper - Exabot	SE
Whispering Sons - Alone	BE
Winter Severity Index - Golden Age / Labyrinth of Memories	IT
Wild Nothing - Paradise	US
Wisteria - Never Waved	US
WYDROB;gothcandy - TAKE UR CIGARETTE	US
xójira - TLAOCOYANI	
xójira;pluto's ashtray - palinopsia ilusoria	
Youryoungbody - January	US
Zanias - Tryptamine Palace	DE
Zanias - Unsaid	DE
Zanias;Serpentskin - Basking In the Light at Heaven's Gate	DE
